000000000
000000000
000000000
000000000
000000000
000000000
000000000
000122300
000455600
000000000
000000000
000000000
000000000
000000000
000000000
000000000
122230000
455560000
000000000
000000000
000000000
000000000
000000000
000000000
000000000
000000012
000000045
000000000
000000000
000000000
223000000
556000000
000000000
000000000
000000000
000000000
000000000
000000000
000000000
000000000
000000000
000000000
000000000
000000000
000000000
000000000
000000000
000000000
000000000
000000000
122230000
455560000
000000000
000000000
000000000
000000000
000000000
000000000
000000000
000000012
000000045
000000000
000000000
000000000
223000000
556000000
000000000
000000000
000000000
000000000
000000000
000000000
000000000
000000000
000000000
000000000
000000000
000000000
000000000
000000000
000000000
