000000000
000000000
000000000
000000000
000000000
000000000
22222b000
00000922e
5eeee6007
a78787b54
078781980
2ddfda036
000100054
056100036
034100054
00072b036
0cb32a524
09a0009b0
00000009b
000000009
000000000
000000000
ceeeeeeeb
afffffff9
078787832
078787800
078787800
078787856
078787811
078787811
0ffffff11
078787811
078787811
b78787878
178787878
17878789a
1ffffffee
17dddd834
110000965
110000541
1100054ca
110054ca0
11054ca00
11032a000
110000000
a10000000
096000000
009600000
000322222
000000000
000000000
000000000
000000000
000000000
000000000
000000000
000000000
000000000
000000000
000000000
000000000
000000000
000000000
ceeeeeeeb
afffffff9
078787832
078787800
078787800
078787856
078787811
078787811
0ffffff11
078787811
078787811
b78787878
178787878
17878789a
1ffffffee
