444444444
444444444
444444444
444444444
444444444
444444444
444444444
444444444
444444444
444444444
444444444
444444444
444444444
444444444
444444444
444444444
444444444
444444444
444444444
544444444
554444444
555544444
555555555
555555555
555555555
544555555
444c55555
444345555
444344555
444344455
444344444
444344444
444344444
22212abcc
444347892
444344444
444344444
00efgefff
00hijhiii
000000000
000000000
effg00000
hiij00000
000000000
666666666
dd0000000
d00000ddd
0000000dd
000000000
000000000
00effg000
00hiij000
000000000
000000000
000000ddd
0000000d0
ddddd00dd
ddd00000d
000000000
000000000
000000000
000000000
000000000
000000000
000000000
000000ddd
0000000d0
ddddd00dd
ddd00000d
000000000
000000000
000000000
000000000
000000000
000000000
000000000
000000000
000000000
