567556755
675567556
755675567
556755675
567556755
675567556
755675567
556755675
567556755
675567556
755675567
556755675
567556755
675567556
755675567
556755675
567556755
675567556
755675567
556755675
222222222
222222222
232222222
233332222
222232222
222232222
222333333
222322222
222322222
224444222
224444442
224444442
224444444
224444444
224444444
222224444
222224444
333334444
333344444
333444444
334444444
000444400
000444400
000444400
000444400
000044440
444444444
004000000
004000000
004000000
000000000
000000000
000000000
000000000
000000000
000000000
000000000
044404444
400404000
404400440
400000004
400404004
044400440
000000000
000000000
000000000
000000000
000000000
000000000
000000000
