000000000
000000000
000000000
000000000
000000000
000000000
000000000
000000000
000000000
000000000
000007800
000005600
078000000
056000000
800000000
580000000
058000078
005800056
000580000
000058000
007805878
005600565
000000000
078000000
765800000
607600000
076000000
760000000
60000bdc0
000000a00
000000a00
999999d9c
000073a48
0bd051d26
00a00aaa0
00a000a00
00a000a00
d9d999d99
148073d0d
51485d992
05148a005
99d26a000
dd260a000
dddd9d99d
0d0a0a00a
0a0a0a00a
bd9d9d99d
0a0a0a000
bd9d9d9dc
000a0a000
000a0a000
bd9d9d9dc
0a0a0a0a0
0a0a0a0a0
ddddddddd
eddddddde
ddedddedd
eddddddde
dd07d80dd
ed73e48de
0a51d26a0
0a05a60a0
dd99d99dd
0a00a00a0
9d99d99d9
ddddadddd
d28aaa71d
a53ddd46a
d9ddedd9d
a71ddd28a
d46dad53d
dd9dad9dd
000000000
000000000
000000000
